F 139, 99, 58
C 171, 154, 137

NO ./assets/textures/bookshelf.xpm
SO ./assets/textures/bookshelf_01.xpm
WE ./assets/textures/bookshelf_02.xpm
EA ./assets/textures/bookshelf_03.xpm

1111111111111111111
1001001001001001001
1001001001001001001
1001001001001001001
1001001000001001001
100000000E000000001
1000011111111000001
1111000000000001111
1000000101010000001
1111111111111111111


