   WE                            ./assets/textures/test-west.xpm 
  NO      ./assets/textures/test-north.xpm



SO ./assets/textures/test-south.xpm

F   69, 222, 199

EA ./assets/textures/test-east.xpm



C 235, 198, 52

111111111111111111111111
100000000000000000000001
100000000000000000000001
100000000000000000000000
100000000000000000000000
100000000000000000000000
100000000000000000000000
100000111110000101010000
100000100010000000000000
100000100010000100010000
100000100010000000000000
100000111100001010100000
100000000000000000000000
100000000000000000000000
100000000000000000000000
100000000000000000000000
100000000000000000000000
100000000000000000000000
100000000000000000000000
100000000000000000000000
100000000000000000000000
1N0000000000000000000000
111111111000000000000000
100100001000000000000000
100000101000000000000000
100100001000000000000001
100111111000000000000001
100000000000000000000001
100000000000000000000001
111111111111111111111111
